00000000000000000000
00000000000110000000
00000000000011110000
00000000000000011110
00111110000000000000
01100011111111000000
00000000000001110000
00000000000000011100
00000000000000000110
00000000000000000000
00000000000000000000
00000000000000000000
00000000000000000000
00000000000000000000
00000000000000000000
00000000000000000000
00000000000000000000
00000000000000000000
00000000000000000000
00000000000000000000
