000000000000000000000
000000000000000000000
001000000000000000100
001000000000000000100
001000000000000000100
001000000000000000100
001000000000000000100
001000000000000000100
001000000000000000100
001000000000000000100
001000000000000000100
001000000000000000100
001000000000000000100
001000000000000000100
001000000000000000100
001000000000000000100
001000000000000000100
001000000000000000100
001111111111111111100
000000000000000000000
000000000000000000000
